[mapsize]
65 59
[maplocdata]
1 3 2 1 3 2 1 3 2 1 3 2 2 1 2 1 2 3 3 3 2 1 2 1 1 1 2 1 2 1 1 1 2 3 1 2 3 1 2 3 1 2 1 2 1 2 1 2 1 3 2 1 2 3 1 2 1 3 1 2 3 1 2 3 1 2
2 3 2 1 3 2 1 3 2 1 3 1 2 1 1 2 1 3 2 1 3 1 2 1 3 1 2 1 2 1 3 2 1 2 3 1 2 3 1 2 3 1 2 3 1 2 3 2 1 3 2 1 3 2 1 2 1 2 1 1 1 1 2 1 3 1
3 2 1 2 3 2 1 2 1 3 2 1 2 3 1 2 1 2 1 1 1 1 2 3 1 2 3 1 2 3 2 1 2 3 1 2 3 1 2 1 2 3 1 3 2 1 2 1 2 1 2 1 2 1 3 2 1 3 2 1 2 2 3 1 1 3
1 3 2 1 3 2 1 3 2 1 3 2 2 1 2 1 2 3 3 3 2 1 2 1 1 1 2 1 2 1 1 1 2 3 1 2 3 1 2 3 1 2 1 2 1 2 1 2 1 3 2 1 2 3 1 2 1 3 1 2 3 1 2 3 1 2
2 1 3 2 1 3 2 1 3 1 2 1 1 2 1 3 2 1 3 1 2 1 3 1 2 1 2 1 3 2 1 2 3 1 2 3 1 2 3 1 2 3 1 2 3 2 1 3 2 1 3 2 1 2 1 2 1 1 1 1 2 1 3 1 3 3
3 2 1 2 3 2 1 2 1 3 2 1 2 3 1 2 1 2 1 1 1 1 28   3 1 2 3 1 2 3 2 1 2 3 1 2 3 1 2 1 2 3 1 3 2 1 2 1 2 1 2 1 2 1 3 2 1 3 2 1 2 2 3 1 1 3
1 3 2 1 3 2 1 3 2 1 3 2 2 1 2 1 2 3 3 3 2 1 53 1 1 1 2 1 2 1 1 1 2 3 1 2 3 1 2 3 1 2 1 2 1 2 1 2 1 3 2 1 2 3 1 2 1 3 1 2 3 1 2 3 1 2
2 3 2 1 3 2 1 3 2 1 3 1 2 1 1 2 1 3 2 1 3 1 53 1 3 1 2 1 2 1 3 2 1 2 3 1 2 3 1 2 3 1 2 3 1 2 3 2 1 3 2 1 3 2 1 2 1 2 1 1 1 1 2 1 3 1
3 2 1 2 3 2 1 2 1 3 2 1 2 3 1 2 1 2 1 1 1 1 53 3 1 2 3 1 2 3 2 1 2 3 1 2 3 1 2 1 2 3 1 3 2 1 2 1 2 1 2 1 2 1 3 2 1 3 2 1 2 2 3 1 1 3
2 1 3 2 1 3 2 1 3 2 2 1 2 1 2 3 3 3 2 1 2 1 53 1 2 1 2 1 1 1 2 3 1 2 3 1 2 3 1 2 1 2 1 2 1 2 1 3 2 1 2 3 1 2 1 3 1 2 3 1 2 3 1 2 3 1
2 3 2 1 3 2 1 3 2 1 3 1 2 1 1 2 1 3 2 1 3 1 53 1 3 1 2 1 2 1 3 2 1 2 3 1 2 3 1 2 3 1 2 3 1 2 3 2 1 3 2 1 3 2 1 2 1 2 1 1 1 1 2 1 3 1
2 3 2 1 2 1 3 2 1 2 3 1 2 1 2 1 1 1 1 100 101 101 56 152 152 152 152 152 152 152 55 1 2 3 1 2 1 2 3 1 3 2 1 2 1 2 1 2 1 2 1 3 2 1 3 2 1 2 2 3 1 1 3 2 3 1
1 3 2 1 3 2 1 3 2 1 3 2 2 1 2 1 2 3 3 3 2 1 153 1 1 1 2 1 2 1 153 1 2 3 1 2 3 1 1 3 1 2 1 2 1 2 1 2 1 3 2 1 2 3 1 2 1 3 1 2 3 1 2 3 1 2
2 3 2 1 3 2 1 3 2 1 3 1 2 1 1 2 1 3 2 1 3 1 153 1 3 1 2 1 2 1 153 2 1 2 3 1 2 3 1 2 3 1 2 3 1 2 3 2 1 3 2 1 3 2 1 2 1 2 1 1 1 1 2 1 3 1
3 2 1 2 3 2 1 2 1 3 2 1 2 3 1 2 1 2 1 1 1 1 153 3 1 2 3 1 2 3 153 1 2 3 1 2 3 1 2 1 2 3 1 3 2 1 2 1 2 1 2 1 2 1 3 2 1 3 2 1 2 2 3 1 1 3
1 3 2 1 3 2 1 3 2 1 3 2 2 1 2 1 2 3 3 3 2 1 153 1 1 1 2 1 2 1 153 1 2 3 1 2 3 1 2 3 1 2 1 2 1 2 1 2 1 3 2 1 2 3 1 2 1 3 1 2 3 1 2 3 1 2
2 1 3 2 1 3 2 1 3 1 2 1 1 2 1 3 2 1 3 1 2 1 153 1 2 1 2 1 3 2 178 2 3 1 2 3 1 2 3 1 2 3 1 2 3 2 1 3 2 1 3 2 1 2 1 2 1 1 1 1 2 1 3 1 3 3
3 2 1 2 3 2 1 2 1 3 2 1 2 3 1 2 1 2 1 1 1 1 153 3 1 2 3 1 2 3 2 1 2 3 1 2 3 1 2 1 2 3 1 3 2 1 2 1 2 1 2 1 2 1 3 2 1 3 2 1 2 2 3 1 1 3
1 3 2 1 3 2 1 3 2 1 3 2 2 1 2 1 2 3 3 3 2 1 153 1 1 1 2 1 2 1 1 1 2 3 1 2 3 1 2 3 1 2 1 2 1 2 1 2 1 3 2 1 2 3 1 2 1 3 1 2 3 1 2 3 1 2
2 3 2 1 3 2 1 3 2 1 3 1 2 1 1 2 1 3 2 1 3 1 153 1 3 1 2 1 2 1 3 2 1 2 3 1 2 3 1 2 3 1 2 3 1 2 3 2 1 3 2 1 3 2 1 2 1 2 1 1 1 1 2 1 3 1
3 2 1 2 3 2 1 2 1 3 2 1 2 3 1 2 1 2 1 1 1 1 153 3 1 2 3 1 2 3 2 1 2 3 1 2 3 1 2 1 2 3 1 3 2 1 2 1 2 1 2 1 2 1 3 2 1 3 2 1 2 2 3 1 1 3
2 1 3 2 1 3 2 1 3 2 2 1 2 1 2 3 3 3 2 1 2 1 53 1 2 1 2 1 1 1 2 3 1 2 3 1 2 3 1 2 1 2 1 2 1 2 1 3 2 1 2 3 1 2 1 3 1 2 3 1 2 3 1 2 3 1
2 3 2 1 3 2 1 3 2 1 3 1 2 1 1 2 1 3 2 1 3 1 53 1 3 1 2 1 2 1 3 2 1 2 3 1 2 3 1 2 3 1 2 3 1 2 3 2 1 3 2 1 3 2 1 2 1 2 1 1 1 1 2 1 3 1
2 3 2 1 2 1 3 2 1 2 3 1 2 1 2 1 1 1 1 2 3 1 53 3 1 2 3 2 1 2 3 1 2 3 1 2 1 2 3 1 3 2 1 2 1 2 1 2 1 2 1 3 2 1 3 2 1 2 2 3 1 1 3 2 3 1
1 3 2 1 3 2 1 3 2 1 3 2 2 1 2 1 2 3 3 3 2 77 78 79 1 1 2 1 2 1 1 1 2 3 1 2 3 1 2 3 1 2 1 2 1 2 1 2 1 3 2 1 2 3 1 2 1 3 1 2 3 1 2 3 1 2
2 3 2 1 3 2 1 3 2 1 3 1 2 1 1 2 1 3 2 1 3 102 103 104 3 1 2 1 2 1 3 2 1 2 3 1 2 3 1 2 3 1 2 3 1 2 3 2 1 3 2 1 3 2 1 2 1 2 1 1 1 1 2 1 3 1
3 2 1 2 3 2 1 2 1 3 2 1 2 3 1 2 1 2 1 1 1 127 128 129 1 2 3 1 2 3 2 1 2 3 1 2 3 1 2 1 2 3 1 3 2 1 2 1 2 1 2 1 2 1 3 2 1 3 2 1 2 2 3 1 1 3
1 3 2 1 3 2 1 3 2 1 3 2 2 1 2 1 2 3 3 3 2 1 2 1 1 1 2 1 2 1 1 1 2 3 1 2 3 1 2 3 1 2 1 2 1 2 1 2 1 3 2 1 2 3 1 2 1 3 1 2 3 1 2 3 1 2
2 1 3 2 1 3 2 1 3 1 2 1 1 2 1 3 2 1 3 1 2 1 3 1 2 1 2 1 3 2 1 2 3 1 2 3 1 2 3 1 2 3 1 2 3 2 1 3 2 1 3 2 1 2 1 2 1 1 1 1 2 1 3 1 3 3
3 2 1 2 3 2 1 2 1 3 2 1 2 3 1 2 1 2 1 1 1 1 2 3 1 2 3 1 2 3 2 1 2 3 1 2 3 1 2 1 2 3 1 3 2 1 2 1 2 1 2 1 2 1 3 2 1 3 2 1 2 2 3 1 1 3
1 3 2 1 3 2 1 3 2 1 3 2 2 1 2 1 2 3 3 3 2 1 2 1 1 1 2 1 2 1 1 1 2 3 1 2 3 1 2 3 1 2 1 2 1 2 1 2 1 3 2 1 2 3 1 2 1 3 1 2 3 1 2 3 1 2
2 3 2 1 3 2 1 3 2 1 3 1 2 1 1 2 1 3 2 1 3 1 2 1 3 1 2 1 2 1 3 2 1 2 3 1 2 3 1 2 3 1 2 3 1 2 3 2 1 3 2 1 3 2 1 2 1 2 1 1 1 1 2 1 3 1
3 2 1 2 3 2 1 2 1 3 2 1 2 3 1 2 1 2 1 1 1 1 2 3 1 2 3 1 2 3 2 1 2 3 1 2 3 1 2 1 2 3 1 3 2 1 2 1 2 1 2 1 2 1 3 2 1 3 2 1 2 2 3 1 1 3
2 1 3 2 1 3 2 1 3 2 2 1 2 1 2 3 3 3 2 1 2 1 1 1 2 1 2 1 1 1 2 3 1 2 3 1 2 3 1 2 1 2 1 2 1 2 1 3 2 1 2 3 1 2 1 3 1 2 3 1 2 3 1 2 3 1
2 3 2 1 3 2 1 3 2 1 3 1 2 1 1 2 1 3 2 1 3 1 2 1 3 1 2 1 2 1 3 2 1 2 3 1 2 3 1 2 3 1 2 3 1 2 3 2 1 3 2 1 3 2 1 2 1 2 1 1 1 1 2 1 3 1
2 3 2 1 2 1 3 2 1 2 3 1 2 1 2 1 1 1 1 2 3 1 2 3 1 2 3 2 1 2 3 1 2 3 1 2 1 2 3 1 3 2 1 2 1 2 1 2 1 2 1 3 2 1 3 2 1 2 2 3 1 1 3 2 3 1
1 3 2 1 3 2 1 3 2 1 3 2 2 1 2 1 2 3 3 3 2 1 2 1 1 1 2 1 2 1 1 1 2 3 1 2 3 1 2 3 1 2 1 2 1 2 1 2 1 3 2 1 2 3 1 2 1 3 1 2 3 1 2 3 1 2
2 3 2 1 3 2 1 3 2 1 3 1 2 1 1 2 1 3 2 1 3 1 2 1 3 1 2 1 2 1 3 2 1 2 3 1 2 3 1 2 3 1 2 3 1 2 3 2 1 3 2 1 3 2 1 2 1 2 1 1 1 1 2 1 3 1
3 2 1 2 3 2 1 2 1 3 2 1 2 3 1 2 1 2 1 1 1 1 2 3 1 2 3 1 2 3 2 1 2 3 1 2 3 1 2 1 2 3 1 3 2 1 2 1 2 1 2 1 2 1 3 2 1 3 2 1 2 2 3 1 1 3
1 3 2 1 3 2 1 3 2 1 3 2 2 1 2 1 2 3 3 3 2 1 2 1 1 1 2 1 2 1 1 1 2 3 1 2 3 1 2 3 1 2 1 2 1 2 1 2 1 3 2 1 2 3 1 2 1 3 1 2 3 1 2 3 1 2
2 1 3 2 1 3 2 1 3 1 2 1 1 2 1 3 2 1 3 1 2 1 3 1 2 1 2 1 3 2 1 2 3 1 2 3 1 2 3 1 2 3 1 2 3 2 1 3 2 1 3 2 1 2 1 2 1 1 1 1 2 1 3 1 3 3
3 2 1 2 3 2 1 2 1 3 2 1 2 3 1 2 1 2 1 1 1 1 2 3 1 2 3 1 2 3 2 1 2 3 1 2 3 1 2 1 2 3 1 3 2 1 2 1 2 1 2 1 2 1 3 2 1 3 2 1 2 2 3 1 1 3
1 3 2 1 3 2 1 3 2 1 3 2 2 1 2 1 2 3 3 3 2 1 2 1 1 1 2 1 2 1 1 1 2 3 1 2 3 1 2 3 1 2 1 2 1 2 1 2 1 3 2 1 2 3 1 2 1 3 1 2 3 1 2 3 1 2
2 3 2 1 3 2 1 3 2 1 3 1 2 1 1 2 1 3 2 1 3 1 2 1 3 1 2 1 2 1 3 2 1 2 3 1 2 3 1 2 3 1 2 3 1 2 3 2 1 3 2 1 3 2 1 2 1 2 1 1 1 1 2 1 3 1
3 2 1 2 3 2 1 2 1 3 2 1 2 3 1 2 1 2 1 1 1 1 2 3 1 2 3 1 2 3 2 1 2 3 1 2 3 1 2 1 2 3 1 3 2 1 2 1 2 1 2 1 2 1 3 2 1 3 2 1 2 2 3 1 1 3
2 1 3 2 1 3 2 1 3 2 2 1 2 1 2 3 3 3 2 1 2 1 1 1 2 1 2 1 1 1 2 3 1 2 3 1 2 3 1 2 1 2 1 2 1 2 1 3 2 1 2 3 1 2 1 3 1 2 3 1 2 3 1 2 3 1
2 3 2 1 3 2 1 3 2 1 3 1 2 1 1 2 1 3 2 1 3 1 2 1 3 1 2 1 2 1 3 2 1 2 3 1 2 3 1 2 3 1 2 3 1 2 3 2 1 3 2 1 3 2 1 2 1 2 1 1 1 1 2 1 3 1
2 3 2 1 2 1 3 2 1 2 3 1 2 1 2 1 1 1 1 2 3 1 2 3 1 2 3 2 1 2 3 1 2 3 1 2 1 2 3 1 3 2 1 2 1 2 1 2 1 2 1 3 2 1 3 2 1 2 2 3 1 1 3 2 3 1
1 3 2 1 3 2 1 3 2 1 3 2 2 1 2 1 2 3 3 3 2 1 2 1 1 1 2 1 2 1 1 1 2 3 1 2 3 1 2 3 1 2 1 2 1 2 1 2 1 3 2 1 2 3 1 2 1 3 1 2 3 1 2 3 1 2
2 3 2 1 3 2 1 3 2 1 3 1 2 1 1 2 1 3 2 1 3 1 2 1 3 1 2 1 2 1 3 2 1 2 3 1 2 3 1 2 3 1 2 3 1 2 3 2 1 3 2 1 3 2 1 2 1 2 1 1 1 1 2 1 3 1
3 2 1 2 3 2 1 2 1 3 2 1 2 3 1 2 1 2 1 1 1 1 2 3 1 2 3 1 2 3 2 1 2 3 1 2 3 1 2 1 2 3 1 3 2 1 2 1 2 1 2 1 2 1 3 2 1 3 2 1 2 2 3 1 1 3
1 3 2 1 3 2 1 3 2 1 3 2 2 1 2 1 2 3 3 3 2 1 2 1 1 1 2 1 2 1 1 1 2 3 1 2 3 1 2 3 1 2 1 2 1 2 1 2 1 3 2 1 2 3 1 2 1 3 1 2 3 1 2 3 1 2
2 1 3 2 1 3 2 1 3 1 2 1 1 2 1 3 2 1 3 1 2 1 3 77 78 79 2 1 3 2 1 2 3 1 2 3 1 2 3 1 2 3 1 2 3 2 1 3 2 1 3 2 1 2 1 2 1 1 1 1 2 1 3 1 3 3
3 2 1 2 3 2 1 2 1 3 2 1 2 3 1 2 1 2 1 1 1 1 2 102 103 104 3 1 2 3 2 1 2 3 1 2 3 1 2 1 2 3 1 3 2 1 2 1 2 1 2 1 2 1 3 2 1 3 2 1 2 2 3 1 1 3
1 3 2 1 3 2 1 3 2 1 3 2 2 1 2 1 2 3 3 3 2 1 2 127 128 129 2 1 2 1 1 1 2 3 1 2 3 1 2 3 1 2 1 2 1 2 1 2 1 3 2 1 2 3 1 2 1 3 1 2 3 1 2 3 1 2
2 3 2 1 3 2 1 3 2 1 3 1 2 1 1 2 1 3 2 1 3 1 2 1 153 1 2 1 2 1 3 2 1 2 3 1 2 3 1 2 3 1 2 3 1 2 3 2 1 3 2 1 3 2 1 2 1 2 1 1 1 1 2 1 3 1
3 2 1 2 3 2 1 2 1 3 2 1 2 3 1 2 1 2 1 1 1 1 2 3 153 2 3 1 2 3 2 1 2 3 1 2 3 1 2 1 2 3 1 3 2 1 2 1 2 1 2 1 2 1 3 2 1 3 2 1 2 2 3 1 1 3
2 1 3 2 1 3 2 1 3 2 2 1 2 1 2 3 3 3 2 1 2 1 1 1 153 1 2 1 1 1 2 3 1 2 3 1 2 3 1 2 1 2 1 2 1 2 1 3 2 1 2 3 1 2 1 3 1 2 3 1 2 3 100 101 101 101
2 3 2 1 3 2 1 3 2 1 3 1 2 1 1 2 1 3 2 1 3 1 2 1 153 1 2 1 2 1 3 2 1 2 3 1 2 3 1 2 3 1 2 3 1 2 3 2 1 3 2 1 3 2 1 2 1 2 1 1 1 1 2 1 3 100
2 3 2 1 2 1 3 2 1 2 3 1 2 1 2 1 1 1 1 28 3 1 2 3 153 2 3 2 1 2 3 1 2 3 1 2 1 2 3 1 3 2 1 2 1 2 1 2 1 2 1 3 2 1 3 2 1 2 2 3 1 1 3 2 3 1
[OBJLAYER0]
0   0   0   0   0   0   0   5   0   0   0   0   0   0   0   0   0   0   0   0   0   0   0   0   0   0   0   0   0   0   0   0   0   0  0  0   0   0   0   0   0   0   0   0   0   0   0   0   0   0   0   0   0   0   0   0   0   0   0   0   0   0   0   0   0   0
0   4   0   0   0   0   0   0   0   0   0   0   0   0   0   0   0   0   0   0   0   0   0   0   0   0   0   0   0   0   0   0   0   0  0  0   0   0   0   0   0   0   0   0   0   0   0   0   0   0   0   0   0   0   0   0   0   0   0   0   0   0   0   0   0   0
0   0   0   0   0   0   0   0   0   0   0   0   0   0   0   0   0   0   0   0   0   0   0   0   0   0   0   0   0   0   0   0   0   0  0  0   0   0   0   0   0   0   0   0   0   0   0   0   0   0   0   0   0   0   0   0   0   0   0   0   0   0   0   0   0   0
0   0   0   0   0   0   0   0   0   2   0   0   0   0   0   0   0   0   0   0   0   0   0   0   0   0   0   0   0   0   0   0   0   0  0  0   0   0   0   0   0   0   0   0   0   0   0   0   0   0   0   0   0   0   0   0   0   0   0   0   0   0   0   0   0   0
0   0   0   0   0   0   0   0   0   0   0   0   0   0   0   0   0   0   0   0   0   0   0   0   0   0   0   0   0   0   0   0   0   0  0  0   0   0   0   0   0   0   0   0   0   0   0   0   0   0   0   0   0   0   0   0   0   0   0   0   0   0   0   0   0   0
0   0   0   0   0   0   0   0   0   0   0   0   0   0   0   0   0   0   0   0   0   0   0   0   0   0   0   0   0   0   0   0   0   0  0  0   0   0   0   0   0   0   0   0   0   0   0   0   0   0   0   0   0   0   0   0   0   0   0   0   0   0   0   0   0   0
0   0   0   0   4   0   0   0   0   0   0   0   0   0   0   0   0   0   0   0   0   0   0   0   0   0   0   0   0   0   0   0   0   0  0  0   0   0   0   0   0   0   0   0   0   0   0   0   0   0   0   0   0   0   0   0   0   0   0   0   0   0   0   0   0   0
0   0   0   0   0   0   0   0   0   0   0   0   0   0   0   0   0   0   0   0   0   0   0   0   0   0   0   0   0   0   0   0   0   0  0  0   0   0   0   0   0   0   0   0   0   0   0   0   0   0   0   0   0   0   0   0   0   0   0   0   0   0   0   0   0   0
0   0   0   1   0   0   0   0   0   0   0   1   0   0   0   0   0   0   0   0   0   0   0   0   0   0   0   0   0   0   0   0   0   0  0  0   0   0   0   0   0   0   0   0   0   0   0   0   0   0   0   0   0   0   0   0   0   0   0   0   0   0   0   0   0   0
0   0   0   0   0   0   0   0   0   0   0   0   0   0   0   0   0   0   0   0   0   0   0   0   0   0   0   0   0   0   0   0   0   0  0  0   0   0   0   0   0   0   0   0   0   0   0   0   0   0   0   0   0   0   0   0   0   0   0   0   0   0   0   0   0   0
0   0   0   0   0   0   0   0   0   0   0   0   0   0   0   0   0   0   0   0   0   0   0   0   0   0   0   0   0   0   0   0   0   0  0  0   0   0   0   0   0   4   0   0   0   0   0   0   0   0   0   0   0   0   0   0   0   0   0   0   0   0   0   0   0   0
0   3   0   0   3   0   0   0   0   0   0   0   0   0   0   0   0   0   0   0   0   0   0   0   0   0   0   0   0   0   0   0   0   0  0  0   0   0   0   0   0   0   0   0   0   0   0   0   0   0   0   0   0   0   0   0   0   0   0   0   0   0   0   0   0   0
0   0   0   0   0   0   0   0   0   0   0   0   0   0   0   0   0   0   0   0   0   0   0   0   0   0   0   0   0   0   0   0   0   0  0  0   0   0   0   0   0   0   0   0   0   0   0   0   0   0   0   0   0   0   0   0   0   0   0   0   0   0   0   0   0   0
0   0   0   0   0   0   0   0   0   0   0   0   0   0   0   0   0   0   0   0   0   0   0   0   0   0   0   0   0   0   0   0   0   0  0  0   0   4   0   0   0   0   0   0   0   0   0   0   0   0   0   0   0   0   0   0   0   0   0   0   0   0   0   0   0   0
0   0   0   0   0   0   0   27  0   0   0   0   0   0   0   0   0   0   0   2   0   0   0   0   0   0   0   0   0   0   0   0   0   0  0  0   0   0   0   0   0   0   0   0   0   0   0   0   0   0   0   0   0   0   0   0   0   0   0   0   0   0   0   0   0   0
0   3   0   0   3   0   0   52  0   0   0   0   0   0   0   0   0   0   0   0   0   0   0   0   0   0   0   0   0   0   0   0   0   0  0  0   0   0   0   0   0   0   0   0   0   0   0   0   0   0   0   0   0   0   0   0   0   0   0   0   0   0   0   0   0   0
0   0   0   0   0   0   0   52  0   0   0   0   0   0   0   0   0   0   0   0   0   0   0   0   0   0   0   0   0   0   0   0   0   0  0  0   0   0   0   0   0   0   0   0   0   0   0   0   0   0   0   0   0   0   0   0   0   0   0   0   0   0   0   0   0   0
0   0   0   0   0   0   0   52  0   4   0   0   0   0   0   0   0   0   0   0   0   0   0   0   0   0   0   0   0   0   0   0   0   0  0  0   0   0   0   0   0   0   0   0   0   0   0   4   0   0   0   0   0   0   0   0   0   0   0   0   0   0   0   0   0   0
0   0   0   0   0   0   0   52  0   0   0   0   0   0   0   0   0   0   0   0   0   0   0   0   0   0   0   0   0   0   0   0   0   0  0  0   0   0   0   0   0   0   0   0   0   0   0   0   0   0   0   0   0   0   0   0   0   0   0   0   0   0   0   0   0   0
0   0   0   0   0   0   0   52  0   0   0   0   0   0   0   0   2   0   0   0   0   0   0   0   0   0   0   0   0   0   0   0   0   0  0  0   0   0   0   0   0   0   0   0   0   0   0   0   0   0   0   0   0   0   0   0   0   0   0   0   0   0   0   0   0   0
0   0   0   0   0   0   0   52  0   0   0   0   0   0   0   0   0   0   0   0   0   0   0   0   0   0   0   0   0   0   0   0   0   0  0  0   0   0   0   0   0   0   0   0   0   0   0   0   0   0   0   0   0   0   0   0   0   0   0   0   0   0   0   0   0   0
0   0   0   0   0   0   0   52  0   0   0   0   0   0   0   0   0   0   0   0   0   0   0   0   0   0   0   0   0   0   0   0   0   0  0  0   0   0   0   0   0   0   0   0   0   0   0   0   0   0   0   0   0   0   0   0   0   0   0   0   0   0   0   0   0   0
0   0   0   0   0   0   0   52  0   0   0   0   0   0   0   0   0   0   0   0   0   0   0   0   0   0   0   0   0   0   0   0   0   0  0  0   0   0   0   0   0   0   0   0   0   0   0   0   0   0   0   0   0   0   0   0   0   0   0   0   0   0   0   0   0   0
0   0   0   0   0   0   0   52  0   0   0   0   0   0   0   0   0   0   0   0   0   0   0   0   0   0   0   0   0   0   0   0   0   0  0  0   0   0   0   0   0   0   0   0   0   0   0   0   0   0   0   0   0   0   0   0   0   0   0   0   0   0   0   0   0   0
0   0   0   0   0   0   0   101 78  78  78  78  78  78  79  0   0   0   0   0   0   0   0   0   0   0   0   0   0   0   0   0   0   0  0  0   0   0   0   0   0   0   0   0   0   0   0   0   0   0   0   0   0   0   0   0   0   0   0   0   0   0   0   0   0   0
0   0   0   0   0   0   0   0   0   0   0   0   0   0   0   0   4   0   0   0   0   0   0   0   0   0   0   0   0   0   0   0   0   0  0  0   0   0   0   0   0   0   0   0   0   0   0   0   0   0   0   0   0   0   0   0   0   0   0   0   0   0   0   0   0   0
0   0   0   0   0   0   0   0   0   0   0   0   0   0   0   0   0   0   0   0   0   0   0   0   0   0   0   0   0   0   0   0   0   0  0  0   0   0   0   0   0   4   0   0   0   0   0   0   0   0   0   0   0   0   0   0   0   0   0   0   0   0   0   0   0   0
0   0   0   0   0   0   0   0   0   0   0   0   0   0   0   0   0   0   0   0   0   0   0   0   0   0   0   0   0   0   0   0   0   0  0  0   0   0   0   0   0   0   0   0   0   0   0   0   0   0   0   0   0   0   0   0   0   0   0   0   0   0   0   0   0   0
0   0   0   4   0   0   0   0   0   0   0   0   0   0   0   0   0   0   0   0   0   0   0   0   0   0   0   0   0   0   0   0   0   0  0  0   0   0   0   0   0   0   0   0   0   0   0   0   0   0   0   0   0   0   0   0   0   0   0   0   0   0   0   0   0   0
0   0   0   0   0   0   0   0   0   0   0   0   0   0   0   0   0   0   0   0   0   0   0   0   0   0   0   0   0   0   0   0   0   0  0  0   0   0   0   0   0   0   0   0   0   0   0   0   0   0   0   0   0   0   0   0   0   0   0   0   0   0   0   0   0   0
0   0   0   0   0   0   0   0   0   0   0   0   0   0   0   0   0   0   0   0   0   0   0   0   0   0   0   0   0   0   0   0   0   0  0  0   0   0   0   0   0   0   0   0   0   0   0   0   0   0   0   0   0   0   0   0   0   0   0   0   0   0   0   0   0   0
0   0   0   0   0   0   0   0   0   0   0   0   0   0   0   2   0   0   0   0   0   0   0   0   0   0   0   0   0   0   0   0   0   0  0  0   0   0   0   0   0   0   0   0   0   0   0   0   0   0   0   0   0   0   0   0   0   0   0   0   0   0   0   0   0   0
0   0   0   0   0   0   0   0   0   0   0   0   0   0   0   0   0   0   0   0   0   0   0   0   0   0   0   0   0   0   0   0   0   0  0  0   0   0   0   0   0   0   0   0   0   0   0   0   0   0   0   0   0   0   0   0   0   0   0   0   0   0   0   0   0   0
0   0   5   5   5   0   0   0   0   0   0   0   0   0   0   0   0   0   0   0   0   0   0   0   0   0   0   0   0   0   0   0   0   0  0  0   0   0   0   0   0   0   0   0   0   0   0   0   0   0   0   0   0   0   0   0   0   0   0   0   0   0   0   0   0   0
0   0   0   0   0   0   0   0   0   0   0   0   0   0   0   0   0   0   0   0   0   0   0   0   0   0   0   0   0   0   0   0   0   0  0  0   0   0   0   0   0   0   0   0   0   0   0   0   0   0   0   0   0   0   0   0   0   0   0   0   0   0   0   0   0   0
0   0   0   0   0   0   0   0   0   0   0   0   0   0   0   0   0   0   0   0   0   0   0   0   0   0   0   0   0   0   0   0   0   0  0  0   0   0   0   0   0   0   0   0   0   0   0   0   0   0   0   0   0   0   0   0   0   0   0   0   0   0   0   0   0   0
0   0   0   0   0   0   0   0   0   0   0   0   0   0   0   0   0   0   0   0   0   0   0   0   0   0   0   0   0   0   0   0   0   0  0  0   0   0   0   0   0   0   0   0   0   0   0   0   0   0   0   0   0   0   0   0   0   0   0   0   0   0   0   0   0   0
0   0   0   0   0   0   0   0   0   0   0   0   0   0   0   0   0   0   0   0   0   0   0   0   0   0   0   0   0   0   0   0   0   0  0  0   0   0   0   0   0   0   0   0   0   0   0   0   0   0   0   0   0   0   0   0   0   0   0   0   0   0   0   0   0   0
0   0   0   0   0   0   0   0   0   0   0   0   0   0   0   0   1   0   0   0   0   0   0   0   0   0   0   0   0   0   0   0   0   0  0  0   0   0   0   0   0   0   0   0   0   0   0   0   0   0   0   0   0   0   0   0   0   0   0   0   0   0   0   0   0   0
0   0   0   0   0   0   0   0   0   0   0   0   0   0   0   0   0   0   0   0   0   0   0   0   0   0   0   0   0   0   0   0   0   0  0  0   0   0   0   0   0   0   0   0   0   0   0   0   0   0   0   0   0   0   0   0   0   0   0   0   0   0   0   0   0   0
0   0   0   0   0   0   0   0   0   0   0   0   0   0   0   0   0   0   0   0   0   0   0   0   0   0   0   0   0   0   0   0   0   0  0  0   0   0   0   0   0   0   0   0   0   0   0   0   0   0   0   0   0   0   0   0   0   0   0   0   0   0   0   0   0   0
0   0   0   0   0   0   0   0   0   0   0   0   0   0   0   0   0   0   0   0   0   0   0   0   0   0   0   0   0   0   0   0   0   0  0  0   0   0   0   0   0   0   0   0   0   0   0   0   0   0   0   0   0   0   0   0   0   0   0   0   0   0   0   0   0   0
0   0   0   0   0   0   0   0   0   0   0   0   0   0   0   0   0   0   0   0   0   0   0   0   0   0   0   0   0   0   0   0   0   0  0  0   0   0   0   0   0   0   0   0   0   0   0   0   0   0   0   0   0   0   0   0   0   0   0   0   0   0   0   0   0   0
0   0   2   0   0   0   0   0   0   0   0   0   0   0   0   0   0   0   4   0   0   0   0   0   0   0   0   0   0   0   0   0   0   0  0  0   0   0   0   0   0   0   0   0   0   0   0   0   0   0   0   0   0   0   0   0   0   0   0   0   0   0   0   0   0   0
0   0   0   0   0   0   0   0   0   0   0   0   0   0   0   0   0   0   4   0   0   0   0   0   0   0   0   0   0   0   0   0   0   0  0  0   0   0   0   0   0   0   0   0   0   0   0   0   0   0   0   0   0   0   0   0   0   0   0   0   0   0   0   0   0   0
0   0   0   0   0   0   0   0   0   0   0   0   0   0   0   0   0   0   0   0   0   0   0   0   0   0   0   0   0   0   0   0   0   0  0  0   0   0   0   0   0   0   0   0   0   0   0   0   0   0   0   0   0   0   0   0   0   0   0   0   0   0   0   0   0   0
0   0   0   0   0   0   0   0   0   0   0   0   0   0   0   0   0   0   0   0   0   0   0   0   0   0   0   0   0   0   0   0   0   0  0  0   0   0   0   0   0   0   0   0   0   0   0   0   0   0   0   0   0   0   0   0   0   0   0   0   0   0   0   0   0   0
0   0   0   0   0   0   0   0   0   0   0   0   0   0   0   0   0   0   0   0   0   0   0   0   0   0   0   0   0   0   0   0   0   0  0  0   0   0   0   0   0   0   0   0   0   0   0   0   0   0   0   0   0   0   0   0   0   0   0   0   0   0   0   0   0   0
0   0   0   0   0   0   0   0   0   0   0   0   0   0   0   0   0   0   0   0   0   0   0   0   0   0   0   0   0   0   0   0   0   0  0  0   0   0   0   0   0   0   0   0   0   0   0   0   0   0   0   0   0   0   0   0   0   0   0   0   0   0   0   0   0   0
0   0   0   0   4   0   0   0   0   0   0   0   0   0   0   0   0   0   0   0   0   0   0   0   0   0   0   0   0   0   0   0   0   0  0  0   0   0   0   0   0   0   0   0   0   0   0   0   0   0   0   0   0   0   0   0   0   0   0   0   0   0   0   0   0   0
0   0   0   0   0   0   0   0   0   0   0   0   0   0   0   0   0   0   0   0   0   0   0   0   0   0   0   0   0   0   0   0   0   0  0  0   0   0   0   0   0   0   0   0   0   0   0   0   0   0   0   0   0   0   0   0   0   0   0   0   0   0   0   0   0   0
0   0   0   0   0   0   0   0   0   0   0   0   0   0   0   0   0   0   0   0   0   0   0   0   0   0   0   0   0   0   0   0   0   0  0  0   0   0   0   0   0   0   0   0   0   0   0   0   0   0   0   0   0   0   0   0   0   0   0   0   0   0   0   0   0   0
78  78  78  78  78  78  78  78  78  78  78  78  78  78  78  78  78  78  78  79  0   0   0   0   0   0   0   75  78  78  78  78  78  78 79 0   0   0   0   75  78  78  78  78  78  78  79  0   0   0   0   0   75  78  78  78  78  78  78  78  78  78  78  78  78  78
0   0   0   0   0   0   0   0   0   0   0   0   0   0   0   0   0   0   0   0   0   0   0   0   0   0   0   0   0   0   0   0   0   0  0  0   0   0   0   0   0   0   0   0   0   0   0   0   0   0   0   0   0   0   0   0   0   0   0   0   0   0   0   0   0   0
0   0   0   0   0   0   0   0   0   0   0   0   0   0   0   0   0   0   0   0   0   0   0   0   0   0   0   0   0   0   0   0   0   0  0  0   0   0   0   0   0   0   0   0   0   0   0   0   0   0   0   0   0   0   0   0   0   0   0   0   0   0   0   0   0   0
0   0   0   0   0   0   0   0   0   0   0   0   0   0   0   0   0   0   0   0   0   0   0   0   0   0   0   0   0   0   0   0   0   0  0  0   0   0   0   0   0   0   0   0   0   0   0   0   0   0   0   0   0   0   0   0   0   0   0   0   0   0   0   0   0   0
0   3   0   3   0   0   0   0   0   0   0   0   0   0   0   0   0   0   0   0   0   0   0   0   0   0   0   0   0   0   0   0   0   0  0  0   0   0   0   0   0   0   0   0   0   0   0   0   0   0   0   0   0   0   0   0   0   0   0   0   0   0   0   0   0   0
0   0   0   0   0   0   0   0   0   0   0   0   0   0   0   0   0   0   0   0   0   0   0   0   0   0   0   0   0   0   0   0   0   0  0  0   0   0   0   0   0   0   0   0   0   0   0   0   0   0   0   0   0   0   0   0   0   0   0   0   0   3   0   3   0   0
0   0   0   0   0   0   0   0   0   0   0   0   0   0   0   0   0   0   0   0   0   0   0   0   0   0   0   0   0   0   0   0   0   0  0  0   0   0   0   0   0   0   0   0   0   0   0   0   0   0   0   0   0   0   0   0   0   0   0   0   0   0   0   0   0   0
0   0   0   0   0   0   0   0   0   0   0   0   0   0   0   0   0   0   0   0   0   0   0   0   0   0   0   0   0   0   0   0   0   0  0  0   0   0   0   0   0   0   0   0   0   0   0   0   0   0   0   0   0   0   0   0   0   0   0   0   0   0   0   0   0   0