[map size]
40 x 30

[map loc data]
1 2 3 2 1 3 2 1 3 1 3 2 1 3 1 2 3 1 2 3 1 2 1 3 1 3 1 2 3 1 2 3 1 2 1 2 3 1 3 1 
3 2 1 3 2 1 3 1 3 2 1 3 1 2 3 1 2 3 1 2 1 3 1 3 1 2 3 1 2 3 1 2 1 2 3 1 3 1 2 1
2 3 2 1 3 2 1 3 1 3 2 1 3 1 2 3 1 2 3 1 2 1 3 1 3 1 2 3 1 2 3 1 2 1 2 3 1 3 1 2
1 2 3 2 1 3 2 1 3 1 3 2 1 3 1 2 3 1 2 3 1 2 1 3 1 3 1 2 3 1 2 3 1 2 1 2 3 1 3 1 
3 2 1 3 1 3 2 1 3 1 2 3 1 2 3 1 2 1 3 1 3 1 2 3 1 2 3 1 2 1 2 3 1 3 1 1 2 3 3 1
1 2 3 2 1 3 2 1 3 1 3 2 1 3 1 2 3 1 2 3 1 2 1 3 1 3 1 2 3 1 2 3 1 2 1 2 3 1 3 1 
3 1 2 3 1 2 1 3 1 3 1 2 3 1 2 3 1 2 1 2 3 1 3 1 1 2 3 2 1 3 2 1 3 1 3 2 1 3 1 2 
1 2 3 2 1 3 2 1 3 1 3 2 1 3 1 2 3 1 2 3 1 2 1 3 1 3 1 2 3 1 2 3 1 2 1 2 3 1 3 1 
3 2 1 3 2 1 3 1 3 2 1 3 1 2 3 1 2 3 1 2 1 3 1 3 1 2 3 1 2 3 1 2 1 2 3 1 3 1 2 1
2 3 2 1 3 2 1 3 1 3 2 1 3 1 2 3 1 2 28 1 2 1 3 1 3 1 2 3 1 2 3 1 2 1 2 3 1 3 1 2
1 2 3 2 1 3 2 1 3 1 3 2 1 3 1 2 3 1 53 3 1 2 1 3 1 3 1 2 3 1 2 3 1 2 1 2 3 1 3 1 
3 2 1 3 1 3 2 1 3 1 2 3 1 2 3 1 2 1 53 1 3 1 2 3 1 2 3 1 2 1 2 3 1 3 1 1 2 3 3 1
1 2 3 2 1 3 2 1 3 1 3 2 1 3 1 2 3 1 53 3 1 2 1 3 1 3 1 2 3 1 2 3 1 2 1 2 3 1 3 1 
3 1 2 3 1 2 1 3 1 3 1 2 3 1 2 3 1 2 53 2 3 1 3 1 1 2 3 2 1 3 2 1 3 1 3 2 1 3 1 2 
1 2 1 2 3 1 2 3 1 3 1 2 3 1 3 1 3 1 55 130 130 130 130 130 131 1 3 2 1 3 2 1 3 1 2 3 1 3 1 2
1 2 3 2 1 3 2 1 3 1 3 2 1 3 1 2 3 1 2 3 1 2 1 3 1 3 1 2 3 1 2 3 1 2 1 2 3 1 3 1 
3 2 1 3 1 3 2 1 3 1 2 3 1 2 3 1 2 1 3 1 3 1 2 3 1 2 3 1 2 1 2 3 1 3 1 1 2 3 3 1
1 2 3 2 1 3 2 1 3 1 3 2 1 3 1 2 3 1 2 3 1 2 1 3 1 3 1 2 3 1 2 3 1 2 1 2 3 1 3 1 
3 1 2 3 1 2 1 3 1 3 1 2 3 1 2 3 1 2 1 2 3 1 3 1 1 2 3 2 1 3 2 1 3 1 3 2 1 3 1 2 
3 2 1 3 2 1 3 1 3 2 28 3 1 2 3 1 2 3 1 2 1 3 1 3 1 2 3 1 2 3 1 2 1 2 3 1 3 1 2 1
1 2 3 2 1 3 2 1 3 1 53 2 1 3 1 2 3 1 2 3 1 2 1 3 1 3 1 2 3 1 2 3 1 2 1 2 3 1 3 1 
3 2 1 3 2 1 3 1 3 2 53 3 1 2 3 1 2 3 1 2 1 3 1 3 1 2 3 1 2 3 1 2 1 2 3 1 3 1 2 1
2 3 2 1 3 2 1 3 1 3 53 1 3 1 2 3 1 2 3 1 2 1 3 1 3 1 2 3 1 2 3 1 2 1 2 3 1 3 1 2
1 2 3 2 1 3 2 1 3 1 53 2 1 3 1 2 3 1 2 3 1 2 1 3 1 3 1 2 3 1 2 3 1 2 1 2 3 1 3 1 
3 2 1 3 1 3 2 1 3 1 53 3 1 2 3 1 2 1 3 1 3 1 2 3 1 2 3 1 2 1 2 3 1 3 1 1 2 3 3 1
1 2 3 2 1 3 2 1 3 1 53 2 1 3 1 2 3 1 2 3 1 2 1 3 1 3 1 2 3 1 2 3 1 2 1 2 3 1 3 1 
1 2 3 2 1 3 2 1 3 1 53 2 1 3 1 2 3 1 2 3 1 2 1 3 1 3 1 2 3 1 2 3 1 2 1 2 3 1 3 1 
3 2 1 3 2 1 3 1 3 2 53 3 1 2 3 1 2 3 1 2 1 3 1 3 1 2 3 1 2 3 1 2 1 2 3 1 3 1 2 1
2 3 2 1 3 2 1 3 1 3 53 1 3 1 2 3 1 2 3 1 2 1 3 1 3 1 2 3 1 2 3 1 2 1 2 3 1 3 1 2
1 2 3 2 1 3 2 1 3 1 53 2 1 3 1 2 3 1 2 3 1 2 1 3 1 3 1 2 3 1 2 3 1 2 1 2 3 1 3 1 
3 2 1 3 1 3 2 1 3 1 53 3 1 2 3 1 2 1 3 1 3 1 2 3 1 2 3 1 2 1 2 3 1 3 1 1 2 3 3 1
1 2 3 2 1 3 2 1 3 1 53 2 1 3 1 2 3 1 2 3 1 2 1 3 1 3 1 2 3 1 2 3 1 2 1 2 3 1 3 1 
